WWWWWWWWWWWWWWW
WS0W00000W0000W
W0WW0WWW0000W0W
W000000WWWW0W0W
WWWWWWW000W00WW
W0000000W0W000W
W000W000W0WWW0W
W00000WWW00000W
W000W000W00WWWW
W0W0W000WWW000W
W00WW000000W00W
W000WWWWWWW000W
W00W0W000000W0W
W000000WWWWWWBW
WWWWWWWWWWWWWWW