WWWWWWWWWWWWWWW
WS0W00000W0000W
W0WW0WWW0000W0W
W0000E0WWWW0W0W
WWWWWWW000W00WW
W0000000W0W000W
W000W000W0WWW0W
W00000WWW00000W
W0000000W00WWWW
W0W000WW0WWW00W
W00W0000000000W
W000WWWWWWW0W0W
W00W0W000000W0W
W000000WWWWWWBW
WWWWWWWWWWWWWWW